11111111111111111111111111111111111111111111111111
10000000000000000000000000000000000000000000000001
10000000000000000000000000000000000000000000000001
10000000000000000000000000000000000000000000011001
10000000000000000000000000000000000000000001100001
10000000000000000000000000000000000000000000000001
10000000000000000000000000000000011111110000000001
10000000000000000000000000000000000000000000000001
10000000000000000000000000000000000000000000000001
10000000000000000000000000000000000000000000000001
10000000000000000000000011111110000000000000000001
10000000000000000000000000000000000000000000000001
10000000000000000000000000000000000000000000000001
10000000000000000000000000000000000000000000000001
10000000000000000000000000000000000000000000000001
10000000011110000000000000000000000000000000000001
10111100000000000000000000000000000000000000000001
10000000000000000000000000000000000000000000000001
10000000111100000000000000000000000000000000000001
10000000000000000000000000000000000000000000000001
10000000000000011100000000000000000000000000000001
10000000000000000000000001111111000000000000000001
10000000000000000000000000000000000000000000000001
10000000000000000000111100000000000000000000000001
10000000000000000000000000000000000000000000000001
10000000000000000111000000000000000000000000000001
10000000000000000000000000000000000000000000000001
10000000000001110000000000000000000000000000000001
10000000000000000000000000000000510000000000000001
11111111111111111111111111111111111111111111111111